1111111111111111111111111111111111
1000000000001000000000000000000001
1E00000000000000000000000000000001
1110010100100000101001000010010001
1100010010111010001001000111010011
1000000000000000000000000000000111
1000000000000000110000000000001111
11001111111111111C1111111111111111
1110000000000000000000000010000001
11110000000000000000000000000000P1
1111111111111111111111111111111111