1111111111111111111111111111111111
1CCCCCCCCCCCCCCCCCCCCCCCCCCCCCCCC1
1ECCCCCCCCCCCCCCCCCCCCCCCCCCCCCCC1
111CC1C1CC1CCCCC1C1CC1CCCC1CC1CCC1
11CCC1CC1C111C1CCC1CC1CCC11CC1CC11
1CCCCCCCCCCCCCCCCCCCCCCCCCCCCCC111
1CCCCCCCCCCCCCCCCCCCCCCCCCCCCC1111
11CC111111111111111111111111111111
111CCCCCCCCCCCCCCCCCCCCCCC1CCCCCC1
1111CCCCCCCCCCCCCCCCCCCCCCCCCCCCP1
1111111111111111111111111111111111