1111111111111111111111111111111111
1C0100C0000C00000000C10010000000C1
1E00000000000000000001C0100C000001
11100101C01C00001C1001001000010001
11C0010010111010001001001011C10011
111111C000000000000001000010000111
1000C10000000000110001111110001111
1001010000110000110000000000001111
100100000111100011C000000000001111
10011111111111111C1111111111111111
11000000C0000000000000000C10000001
111000C00C00000111000000000C100001
111110C1110011111100000000000000P1
1111111111111111111111111111111111