1111111111111111
1111111111111111
1111100000000011
1111100000000C11
1100000111110011
1100001100000011
110P0111E0000011
1111111111111111
1111111111111111