1111111111111111111111111111111111
100000C0000C00000000000000000000C1
1E00000000000000000000C0000C000001
11100101C01C00001C1001000010010001
1100010010111010001001000111C10011
1C00000000000000000000000C00000111
1000000000C0000011C000000000001111
11001111111111111C1111111111111111
11100000C0000000000000000C10000001
1111C000000000C00000000000000000P1
1111111111111111111111111111111111