1111111
1111111
1111111
11C0E11
1100011
110P011
1111111