11111111
11111111
11111111
11C0E111
11000111
110P0111
11111111